┌─────────────────────────────────────────────────────────┐
│                                                         │
│                   #                 #                   │
│                   #                 #                   │
│                   #                 #                   │
│                   #                 #                   │
│                   #                 #                   │
│   #################                 #################   │
│                                                         │
│                            +                            │
│                                                         │
│   #################                 #################   │
│                   #                 #                   │
│                   #                 #                   │
│                   #                 #                   │
│                   #                 #                   │
│                   #                 #                   │
│                                                         │
└─────────────────────────────────────────────────────────┘