┌─────────────────────────────────────────────────────────┐
│                                                         │
│     ####  ####                           ####  ####     │
│     #        #                           #        #     │
│                                                         │
│     #        #                           #        #     │
│     ####  ####                           ####  ####     │
│                                                         │
│                                                         │
│                            +                            │
│                                                         │
│                                                         │
│     ####  ####                           ####  ####     │
│     #        #                           #        #     │
│                                                         │
│     #        #                           #        #     │
│     ####  ####                           ####  ####     │
│                                                         │
└─────────────────────────────────────────────────────────┘