┌─────────────────────────────────────────────────────────┐
│#                                                       #│
│ #                                                     # │
│  #                         +                         #  │
│   #                                                 #   │
│    #                                               #    │
│     #                     ##                      #     │
│      #                   #  #                    #      │
│       #                 #    #                  #       │
│        #               #      #                #        │
│         #             #        #              #         │
│          #           #          #            #          │
│           #         #            #          #           │
│            #       #              #        #            │
│             #     #                #      #             │
│              #   #                  #    #              │
│               # #                    #  #               │
│                #                       #                │
└─────────────────────────────────────────────────────────┘