┌─────────────────────────────────────────────────────────┐
│#########################################################│
│#+                                                      #│
│#                                                       #│
│#                                                       #│
│#                                                       #│
│#                                                       #│
│#                                                       #│
│#                                                       #│
│#                                                       #│
│#                                                       #│
│#                                                       #│
│#                                                       #│
│#                                                       #│
│#                                                       #│
│#                                                       #│
│#                                                       #│
│#########################################################│
└─────────────────────────────────────────────────────────┘