┌─────────────────────────────────────────────────────────┐
│                            #                            │
│                            #                            │
│       +                    #                            │
│                            #                            │
│                            #                            │
│                            #                            │
│                            #                            │
│                            #                            │
│#########################################################│
│                            #                            │
│                            #                            │
│                            #                            │
│                            #                            │
│                            #                            │
│                            #                            │
│                            #                            │
│                            #                            │
└─────────────────────────────────────────────────────────┘